|||||||||||||||||||||||||
|1                  B  P|
|||||||||||||||||||||||||
 B                      |
 |||||||||||||||||||||| |
 B    B          B      |
 ||||||||||||||||||||||||
                        |
|||||||||||||||||||||||||