|||||||||||||||||||||||||
|1                      |
||||||||||||||||||||||| |
|P                      |
|||||||||||||||||||||||||