|||||||||||||||||||||||||
|1                     P|
|||||||||||||||||||||||||
|B                      |
|||||||||||||||||||||||||