|||||||||||||||||||||||||||
|B                        |
||||||||||||||||||||||||| |
|1                       P|
||||||||||||||||||||||| |||
|                         |
|                       | |
||||||||||||||||||||||||| |
|B                        |
|||||||||||||||||||||||||||