|||||||||||||||||||||||||
|  1      ......       P|
| |||||||||||||||||||||||
| |                     |
||||||||||||||||||||||| |
|B    B  ...     B      |
| |||||||||||||||||||||||
|                       |
|||||||||||||||||||||||||