|||||||||||||||||||||||||
|O                      |
||||||||||||||||||||||| |
|P                      |
|||||||||||||||||||||||||