|||||||||||||||||||||||||||||
|  1      ......       P    |
|X||||||||||||||||||||||    |
|X|     B                   |
| |||||||||||||||||||||     |
|B               B  ...     |
| ||||||||||||||||||||||    |
|                           |
|||||||||||||||||||||||||||||
|P         T               ||
|  |||||||| |||||||||||||| ||
|         T                ||
|||||||||||||||||||||||||||||