|||||||||||||||||||||||||||||
|  1      ......            |
|X||||||||||||||||||||||    |
|X|                     ....|
| ||||||||||||||||||||| ....|
|B    B          B      ....|
| ||||||||||||||||||||||....|
|  T         P              |
| ||||||||| ||||||||||||    |
|      T                   ||
| ||||||||| |||||||||||||| ||
|                    T     ||
|||||||||||||||||||||||||||||