|||||||||||||||||||||||||||||
|  1      ......            |
|X||||||||||||||||||||||    |
|X|                     ....|
| ||||||||||||||||||||| ....|
|B    B          B      ....|
| ||||||||||||||||||||||....|
|            P              |
| ||||||||| ||||||||||||    |
|                          ||
| ||||||||| |||||||||||||| ||
|                          ||
|||||||||||||||||||||||||||||