|||||||||||||||||||||||||||||
|  1      ...|..           P|
|X||||||||   ||||||||||||| ||
|X|B                    ....|
| ||||||||||||||||||||| ....|
|   T            B      ....|
| ||||||||||||||||||||||....|
|            P              |
|   T                       |
|                          ||
| |||||||||||||||||||||||| ||
|           B              ||
|||||||||||||||||||||||||||||