|||||||||||||||||||||||||||||
|  1      ...|..           P|
|X||||||||   ||||||||||||| ||
|X|B                    ....|
| ||||||||||||||||||||| ....|
|                B      ....|
| ||||||||||||||||||||||....|
|            P              |
|                           |
|                          ||
| |||||||||||||||||||||||| ||
|           B              ||
|||||||||||||||||||||||||||||