|||||||||||||||||||||||||||||
|  1      ...|..           P|
|X|||||||| | ||||||||||||| ||
|X|B                    ....|
|X||||||||||||||||||||| ....|
|X               B      ....|
|X||||||||||||||||||||||....|
|X           P              |
|X       B                  |
|  B                       ||
 |||||||||||||||||||||||| ||
|           B              ||
|||||||||||||||||||||||||||||