|||||||||||||||||||||||||||||
|  1      ...|..           P|
|X|||||||| | ||||||||||||| ||
|X|B      T             ....|
|X||||||||||||||||||||| ....|
|X               B      ....|
|X||||||||||||||||||||||....|
|X           P              |
|X       B T                |
|  B                       ||
 |||||||||||||||||||||||| ||
|           B              ||
|||||||||||||||||||||||||||||